S....#####
.##.#.....
.##.#.####
...#.E....
.##.#####.
...#......
.###.####.
.....#....
####..###.
..........